--------------------
--------------------
--------------------
-----------------?Q-
------ooooooo-------
---XX---------------
----------------XX--
---------XX---------
--------------oo----
--E-----------SS----
-<>-----------------
-[]---------XXXXX---
-[]-----------------
XXXX--XXXX----------
